A	AH
A(2)	EY
ARE	AA R
ARE(2)	ER
BOOKSHELF	B UH K SH EH L F
CAN	K AE N
CAN(2)	K AH N
CUBE	K Y UW B
DO	D UW
FOR	F AO R
FOR(2)	F ER
FOR(3)	F R ER
FROM	F R AH M
GARBAGE	G AA R B IH JH
GO	G OW
GOODBYE	G UH D B AY
HOW	HH AW
IS	IH Z
ME	M IY
NAME	N EY M
OLD	OW L D
PHOTO	F OW T OW
TAKE	T EY K
THANK	TH AE NG K
THE	DH AH
THE(2)	DH IY
TO	T UW
TO(2)	T IH
TO(3)	T AH
WHAT	W AH T
WHAT(2)	HH W AH T
WHERE	W EH R
WHERE(2)	HH W EH R
YOU	Y UW
YOUR	Y AO R
YOUR(2)	Y UH R
